00,00,00,00,00,00,00,00,00,00,00,00,00,00,00,00,00,00,00,00,00,00,00,00,00,00,00,00,00,00,00,00,00,00,00,00,00,00,00,00,00,00,00,00,00,00,00,00,00,00,00,00,00,00,00,00,00,00,00,00,00,00,00,00,00,00,00,00,00,00,00,00,00,00,00
00,00,00,00,00,00,00,00,00,00,00,00,00,00,00,00,00,00,00,00,00,00,00,00,00,00,00,00,00,00,00,00,00,00,00,00,00,00,00,00,00,00,00,00,00,00,00,00,00,00,00,00,00,00,00,00,00,00,00,00,00,00,00,00,00,00,00,00,00,00,00,00,00,00,00
00,00,00,00,00,00,00,00,00,00,00,00,00,00,00,00,00,00,00,00,00,00,00,00,00,00,00,00,00,00,00,00,00,00,00,00,00,00,00,00,00,00,00,00,00,00,00,00,00,00,00,00,00,00,00,00,00,00,00,00,00,00,00,00,00,00,00,00,00,00,00,00,00,00,00
00,00,00,00,00,00,00,00,00,00,00,00,00,00,00,00,00,00,00,00,00,00,00,00,00,00,00,00,00,00,00,00,00,00,00,00,00,00,00,00,00,00,00,00,00,00,00,00,00,00,00,00,00,00,00,00,00,00,00,00,00,00,00,00,00,00,00,00,00,00,00,00,00,00,00
00,00,00,00,00,00,00,00,00,00,00,00,00,00,00,00,00,00,00,00,00,00,00,00,00,00,00,00,00,00,00,00,00,00,00,00,00,00,00,00,00,00,00,00,00,00,00,00,00,00,00,00,00,00,00,00,00,00,00,00,00,00,00,00,00,00,00,00,00,00,00,00,00,00,00
00,00,00,00,00,00,00,00,00,00,00,00,00,00,00,00,00,00,00,00,00,00,00,00,00,00,00,00,00,00,00,00,00,00,00,00,00,00,00,00,00,00,00,00,00,00,00,00,00,00,00,00,00,00,00,00,00,00,00,00,00,00,00,00,00,00,00,00,00,00,00,00,00,00,00
00,00,00,00,00,00,00,00,00,00,00,00,00,00,00,00,00,00,00,00,00,00,00,00,00,00,00,00,00,00,00,00,00,00,00,00,00,00,00,00,00,00,00,00,00,00,00,00,00,00,00,00,00,00,00,00,00,00,00,00,00,00,00,00,00,00,00,00,00,00,00,00,00,00,00
00,00,00,00,00,00,00,00,00,00,00,00,00,00,00,00,00,00,00,00,00,00,00,00,00,00,00,00,00,00,00,00,00,00,00,00,00,00,00,00,00,00,00,00,00,00,00,00,00,00,00,00,00,00,00,02,02,02,00,00,00,00,00,00,00,00,00,00,00,00,00,00,00,00,00
00,00,00,00,00,00,00,00,00,00,00,00,00,00,00,00,00,00,00,00,00,00,00,00,00,00,00,00,02,02,00,00,02,02,00,00,02,02,00,00,00,00,00,00,00,00,00,00,00,00,00,00,00,00,00,01,01,01,02,02,00,00,00,00,00,00,00,00,00,00,00,00,00,00,00
00,00,00,00,00,00,00,00,00,00,00,00,00,00,00,00,00,00,00,00,00,00,00,00,00,00,00,00,00,00,00,00,00,00,00,00,00,00,00,00,00,00,00,00,00,00,00,00,00,00,00,00,00,AB,00,01,01,01,01,01,02,00,00,00,00,00,00,00,00,00,00,00,00,00,00
02,00,99,00,00,00,00,00,00,00,00,00,00,00,00,00,00,00,00,00,00,00,00,00,02,02,00,00,00,00,00,00,00,00,00,00,00,00,00,00,02,02,00,00,00,00,00,00,00,00,AB,AB,AB,00,00,01,01,01,01,01,01,02,00,00,00,00,00,00,00,00,00,00,00,00,02
01,00,00,00,00,00,02,02,00,02,02,00,00,00,00,00,00,00,00,00,00,00,02,02,01,01,00,00,00,00,00,00,00,00,00,00,00,00,00,00,01,01,02,02,00,00,00,00,00,AB,00,00,00,00,00,01,01,01,01,01,01,01,02,00,00,00,00,00,00,00,00,00,00,00,01
01,00,00,00,00,02,01,01,00,01,01,02,00,00,00,00,00,11,00,00,02,02,01,01,01,01,02,00,00,00,00,11,00,00,00,11,00,00,00,00,01,01,01,01,02,02,00,00,AA,00,00,00,00,00,00,01,01,01,01,01,01,01,01,02,00,00,00,00,11,00,00,00,00,AD,01
01,02,02,02,02,01,01,00,00,00,01,01,02,02,02,02,02,02,02,02,01,01,01,01,01,01,01,02,02,02,02,02,02,02,02,02,02,02,02,02,01,01,01,01,01,01,02,02,02,02,02,02,02,02,02,01,01,01,01,01,01,01,01,01,02,02,02,02,02,02,02,02,02,02,01