0000000000000000000000000000000000000000000000000000000000000000000000
0000000000000000000000000000000000000000000000000000000000000000000000
0000000000000000000000000000000000000000000000000000000000000000000000
0000000000000000000000000000000000000000000000000000000000000000000000
0000000000000000000000000000000000000000000000000000000000000000000000
0000000000000000000000000000000000000000000000000000000000000000000000
0000000000000000000000000000000000000000000000000000000000000000000000
0000000000000000000000000000000000000000000000000000000000000000000000
0000000000000000000000000000000000000000000000000000000000000000000000
0000000000002000000000000000000000000000000000000000000000000000000000
0000000000021000000000000000000000000000000000000000000000000000000000
0000000000211000000000000000000000000000000000000000000000000000000000
0000000002111000000000000000000000000000000000000000000000000000000000
2222222221111222222222222222222222222222222222222222222222222222222222